%****************
*               *
*  $$$$$$$$$$$  *
* %           % *
* %           % *
*               *
*     $   $     *
*     $   $     *
*               *
****************%